25 15
2
moon.tiles.bmp

7 7 7 7 7 7 7 7 7 7 7 7 7 7 7 7 7 7 7 7 7 7 7 7 7 
7 16 17 17 17 17 17 17 17 17 17 17 17 17 17 17 17 17 17 17 17 17 17 18 7 
7 19 0 0 0 0 0 0 0 0 0 0 0 0 0 0 0 0 0 0 0 0 0 20 7 
7 19 0 2 2 0 0 0 0 0 0 0 0 0 2 2 2 2 2 0 0 0 0 20 7 
7 19 0 2 0 0 0 0 0 0 0 0 0 0 0 2 2 0 0 0 0 0 0 20 7 
7 19 2 0 0 0 0 0 0 0 0 2 0 0 1 2 1 0 0 0 0 0 0 20 7 
7 19 0 0 0 0 0 0 0 0 0 0 0 0 0 2 0 0 0 0 0 0 0 20 7 
7 19 0 0 0 0 0 0 0 3 4 4 4 4 4 4 4 4 4 4 4 5 0 20 7 
7 19 0 0 0 0 2 2 0 6 7 7 7 7 7 7 7 7 7 7 7 8 0 20 7 
7 19 0 0 0 0 0 2 0 6 7 7 7 7 7 7 7 7 7 7 7 8 0 20 7 
7 19 0 0 0 0 12 0 0 9 10 10 10 10 10 10 10 10 10 10 10 11 0 20 7 
7 19 0 0 0 0 0 0 0 0 0 0 0 0 0 0 0 0 0 0 0 0 0 20 7 
7 19 0 0 0 0 0 0 0 0 0 0 0 0 0 0 0 0 0 12 2 2 2 20 7 
7 21 22 22 22 22 22 22 22 22 22 22 22 22 22 22 22 22 22 22 22 22 22 23 7 
7 7 7 7 7 7 7 7 7 7 7 7 7 7 7 7 7 7 7 7 7 7 7 7 7 

4 4 4 4 4 4 4 4 4 4 4 4 4 4 4 4 4 4 4 4 4 4 4 4 4 
4 4 4 4 4 4 4 4 4 4 4 4 4 4 4 4 4 4 4 4 4 4 4 4 4 
4 4 0 0 0 0 0 0 0 0 0 0 0 0 0 0 0 0 0 0 0 0 0 4 4 
4 4 0 1 1 0 0 0 0 0 0 0 0 0 1 1 1 1 1 0 0 0 0 4 4 
4 4 0 1 0 0 0 0 0 0 0 0 0 0 0 1 1 0 0 0 0 0 0 4 4 
4 4 1 0 0 0 0 0 0 0 0 1 0 0 3 1 2 0 0 0 0 0 0 4 4 
4 4 0 0 0 0 0 0 0 0 0 0 0 0 0 1 0 0 0 0 0 0 0 4 4 
4 4 0 0 0 0 0 0 0 4 4 4 4 4 4 4 4 4 4 4 4 4 0 4 4 
4 4 0 0 0 0 1 1 0 4 4 4 4 4 4 4 4 4 4 4 4 4 0 4 4 
4 4 0 0 0 0 0 1 0 4 4 4 4 4 4 4 4 4 4 4 4 4 0 4 4 
4 4 0 0 0 0 1 0 0 4 4 4 4 4 4 4 4 4 4 4 4 4 0 4 4 
4 4 0 0 0 0 0 0 0 0 0 0 0 0 0 0 0 0 0 0 0 0 0 4 4 
4 4 0 0 0 0 0 0 0 0 0 0 0 0 0 0 0 0 0 1 1 1 1 4 4 
4 4 4 4 4 4 4 4 4 4 4 4 4 4 4 4 4 4 4 4 4 4 4 4 4 
4 4 4 4 4 4 4 4 4 4 4 4 4 4 4 4 4 4 4 4 4 4 4 4 4 
